111111111111111111111111111111111111111111111111111111111111111111111XX 11111111111111111111111111111
1   1XXXXXXXXXXXXX  1XXXXXXXXX  1XXXXXXXXX  1XXXXX  1            XXXXX      1XXXXXXXXX      1       1
1   1X  111111111X  1X  11111X  1X  11111X  1X  1X  1   111111111X  111111111X  11111X  1   1   1   1
1  XXX  1      XXX  1X  1  XXX  1X  1    XXXXX  1X  1   1  XXXXXXX  1XXXXXXXXX  1XXXXX  1   1   1   1
1  X111111111  X11111X  1  X11111X  1111111111111X  1   1  X111111111X  111111111X  11111   1   1   1
1  X1XXXXX  1  XXXXXXX  1  X1XXXXX  1           1X  1   1  XXXXX1XXXXX          1X  1   1       1   1
1  X1X  1X  1111111111111  X1X  11111   111111111X  1   11111  X1X  1111111111111X  1   11111   1   1
1  XXX  1X  1   1       1  XXX      1       1XXXXX  1       1  XXX  1XXXXX  1XXXXX  1       1   1   1
111111111X  1   1   1   1111111111111   11111X  111111111111111111111X  1X  1X  111111111   11111   1
1  XXX  1X  1       1                   1  XXX  1  XXXXXXXXXXXXXXXXXXX  1X  1X          1           1
1  X1X  1X  1111111111111   111111111   1  X11111  X11111   1111111111111X  1X  11111   1111111111111
1  X1XXXXX      1           1       1   1  XXX  1  XXX  1       1        XXXXX  1   1   1           1
1  X1111111111111   111111111   1   1   11111X  11111X  1   1   11111111111111111   1   1   1   1   1
1  XXXXX1           1           1   1       1XXXXXXXXX  1   1           1       1       1   1   1   1
1   1  X1   111111111   111111111   11111   1111111111111111111111111   1   1   111111111   1   1   1
1   1  X1           1   1       1   1   1   1           1           1   1   1               1   1   1
1   1  X111111111   1   11111   1   1   1   1   1   1   1   11111   1   111111111   1111111111111   1
1   1  XXXXX1           1       1       1       1   1           1   1           1   1           1   1
111111111  X1111111111111   11111111111111111111111111111   1   1   111111111   1   111111111   1   1
1       1  X1           1   1               1           1   1   1           1   1               1   1
11111   1  X1   111111111   1   1   11111   1   11111   11111   111111111   1   11111111111111111   1
1   1   1  XXXXXXXXXXXXXXX  1   1       1   1       1           1   1       1                   1   1
1   1   1   1111111111111X  111111111   1   1   1   1111111111111   1   111111111111111111111   1   1
1   1       1           1X      1       1   1   1               1   1   1   1           1       1   1
1   111111111   111111111X  1   1   11111   1111111111111   11111   1   1   1   111111111   11111   1
1   1           1XXXXXXXXX  1   1       1   1       1       1       1       1           1   1       1
1   1   111111111X  1111111111111   1   1   1   1   1   11111   111111111111111111111   1   1   11111
1       1       1X  1               1   1   1   1           1                   1       1   1       1
1   1   1   1   1X  1   11111111111111111   1   111111111   1   111111111   1   1   1   1   11111   1
1   1   1   1   1X  1                   1   1       1       1   1           1       1   1       1   1
11111   11111   1X  11111111111111111   1   11111   1   11111   1   11111111111111111   11111   1   1
1       1       1X  1       1       1   1       1   1   1       1       1           1       1   1   1
1   11111   1   1X  1   1   1   1   1   11111   1   11111   111111111   111111111   1   1   1   1   1
1   1       1    X  1   1   1   1       1           1       1           1       1   1   1           1
1   1111111111111X  1   1   1111111111111   111111111   11111   111111111   1   1   11111111111111111
1   1  XXXXXXXXXXX  1   1           1       1       1   1                   1   1           1       1
1   1  X1111111111111   111111111   1   11111   1   1   11111111111111111   1   111111111   1   1   1
1   1  XXXXXXXXX1   1       1       1       1   1       1       1           1               1   1   1
1   111111111  X1   11111   1   11111   1   1   111111111   1   1   1111111111111111111111111   1   1
1       1   1  X1           1       1   1       1           1           1XXXXXXXXX              1   1
11111   1   1  X11111111111111111   1   111111111   111111111111111111111X  11111X  1111111111111   1
1       1      XXXXXXXXXXXXX    1       1           1XXXXXXX1XXXXXXXXXXX1X  1XXXXX  1           1   1
1   1111111111111   11111  X1111111111111111111111111X  1  X1X  1   1  X1X  1X  11111   111111111   1
1   1           1       1  XXXXXXXXXXXXXXXXXXXXXXXXXXX  1  XXX  1   1  XXX  1X  1   1           1   1
1   1   11111   1111111111111111111111111111111111111111111111111   111111111X  1   1   11111   1   1
1       1   1                           1       1               1       1  XXX  1   1       1       1
1   11111   111111111   1111111111111   1   1   1   11111   1   111111111  X11111   11111   11111   1
1       1       1       1       1       1   1       1       1           1  XXX  1   1   1   1       1
11111   1   11111   1   1   1   1   111111111111111111111   111111111   11111X  1   1   1   1   11111
1       1           1       1   1                           1 XXXXXXXXXXXXXXXX  1           1       1
1111111111111111111111111111111111111111111111111111111111111 X 1111111111111111111111111111111111111
