111111111111111111111 XX11111111111111111
1       1              XXXXX1XXXXXXX1   1
1   11111   11111   11111  X1X  1  X1   1
1               1       1  XXX  1  X1   1
1   11111111111111111   111111111  X1   1
1       1               1       1  X1   1
111111111   11111111111111111   1  X1   1
1       1   1       1           1  XXX  1
1   1   1   1   1   1   11111   11111X  1
1   1       1   1       1       1XXXXX  1
1   111111111   111111111   11111X  11111
1               1           1   1X  1   1
111111111   11111   111111111   1X  1   1
1           1       1  XXXXXXXXXXX  1   1
11111   1111111111111  X1111111111111   1
1   1               1  X1XXXXXXX        1
1   1111111111111   1  X1X  1  X111111111
1   1               1  XXX  1  XXXXXXX  1
1   1   11111111111111111111111111111X  1
1       1                     XXXXXXXX  1
11111111111111111111111111111 X 111111111
